EcoRI	G/AATTC
BamHI	G/GATCC
XmaI	C/CCGGG
XmaIII	C/GGCCG
HpaI	GTT/AAC
HpaII	C/CGG
EcoRV	GAT/ATC
XhoI	C/TCGAG
SacI	GAGCT/C
SacII	CCGC/GG
MboI	/GATC
NarI	GG/CGCC
BspMII	T/CCGGA
SmaI	CCC/GGG
AaaI	C/GGCCG
AagI	AT/CGAT
NaeI	GCC/GGC
AanI	TTA/TAA
PsiI	TTA/TAA
ApaLI	GTGCAC
AatI	AGG/CCT
AatII	GACGT/C
StuI	AGG/CCT
AauI	T/GTACA
SalI	G/TCGAC
AccII	CG/CG
AccIII	T/CCGGA
AbaI	T/GATCA
BclI	T/GATCA
NaeI	GCC/GGC
HaeIII	GG/CC
AbrI	C/TCGAGC
BalI	TGG/CCA
AbsI	CC/TCGAGG
AatI	AGG/CCT
AatII	GACGT/C
Acc16I	TGC/GCA
AcII	AA/CGTT
AcvI	CAC/GTG
AfaI	GT/AC
AfeI	AGC/GCT
AfIII	C/TTAAG
AgeI	A/CCGGT
AhII	A/CTAGT
Alw441	G/TGCAC
AluI	AG/CT
Aor51HII	AGC/GCT
ApaI	GGGCC/C
ApaLI	G/TGCAC
AscI	GG/CGCGCC
AseI	AT/TAAT
Asp718I	G/GTACC
AsuII	TT/CGAA
AviII	TGC/GCA
AvrII	C/CTAGG
BaII	TGG/CCA
BanIII	AT/CGAT
BbeI	GGCGC/C
BbrPI	CAC/GTG
BbuI	GCATG/C
BcuI	A/CTAGT
BcII	T/GATCA
BfaI	C/TAG
BfrI	C/TTAAG
BfrBI	ATG/CAT
BgIII	A/GATCT
BlnI	C/CTAGG
BseCI	AT/CGAT
BsePI	G/CGCGC
BseX3I	C/GGCCG
BshTI	A/CCGGT
Bsp1407I	T/GTACA
Bsp19I	C/CATGG
BspDI	AT/CGAT
BspEI	T/CCGGA
BsrGI	T/GTACA
BssHII	G/CGCGC
BstUI	CG/CG
ClaI	AT/CGAT
DraI	TTT/AAA
EagI	C/GGCCG
EgeI	GGC/GCC
FseI	GGCCGG/CC
FspI	TGC/GCA
HaeIII	GG/CC
HindIII	A/AGCTT
KasI	G/GCGCC
KpnI	GGTAC/C
MboI	/GATC
MfeI	C/AATTG
MluI	A/CGCGT
MscI	TGG/CCA
MseI	T/TAA
MspI	C/CGG
NaeI	GCC/GGC
NarI	GG/CGCC
NcoI	C/CATGG
NdeI	CA/TATG
NdeII	/GATC
NgoMIV	G/CCGGC
NheI	G/CTAGC
NotI	GC/GGCCGC
NruI	TCG/CGA
NsiI	ATGCA/T
PacI	TTAAT/TAA
PciI	A/CATGT
PhoI	GG/CC
PmeI	GTTT/AAAC
PmII	CAC/GTG
PsiI	TTA/TAA
PstI	CTGCA/G
PvuI	CGAT/CG
PvuII	CAG/CTG
RsaI	GT/AC
SaII	G/TCGAC
SbfI	CCTGCA/GG
ScaI	AGT/ACT
SfoI	GGC/GCC
SnaBI	TAC/GTA
SpeI	A/CTAGT
SphI	GCATG/C
SspI	AAT/ATT
SstI	GAGCT/C
SstII	CCGC/GG
SwaI	ATTT/AAAT
TaqI	T/CGA
TliI	C/TCGAG
XbaI	T/CTAGA